"ae" = (/obj/machinery/atm{pixel_y = -32},/turf/simulated/floor/tiled/dark/rough,/area/space)
"dh" = (/obj/effect/floor_decal/corner/blue/diagonal,/obj/structure/table/marble,/obj/item/material/kitchen/rollingpin,/obj/item/reagent_containers/spray/cleaner,/obj/item/material/knife,/obj/effect/floor_decal/corner/blue/diagonal,/turf/simulated/floor/tiled/white/rough,/area/space)
"di" = (/obj/structure/table/marble,/obj/effect/floor_decal/corner/blue/diagonal,/obj/item/reagent_containers/vessel/condiment/enzyme{pixel_x = 11; pixel_y = 9},/obj/item/reagent_containers/vessel/beaker{pixel_x = 2; pixel_y = 5},/obj/machinery/reagentgrinder{pixel_x = -10; pixel_y = 5},/turf/simulated/floor/tiled/white/rough,/area/space)
"ef" = (/obj/effect/floor_decal/corner/blue/diagonal,/obj/machinery/cooker/grill,/obj/machinery/light{dir = 8},/obj/machinery/camera/network/civilian_east{c_tag = "Kitchen"; dir = 4},/turf/simulated/floor/tiled/white/rough,/area/space)
"eh" = (/obj/item/stool/bar_new/padded,/turf/simulated/floor/trim/carpet/oldred,/area/space)
"eq" = (/obj/machinery/door/airlock/glass{name = "Saloon"},/turf/simulated/floor/tiled/dark/rough,/area/space)
"eD" = (/obj/effect/floor_decal/corner/blue/diagonal,/obj/machinery/cooker/fryer,/obj/machinery/firealarm{dir = 8; pixel_x = -24; pixel_y = -2},/turf/simulated/floor/tiled/white/rough,/area/space)
"fw" = (/obj/effect/landmark/start/crew/bartender,/turf/simulated/floor/tiled/dark/rough,/area/space)
"gp" = (/obj/structure/closet/secure_closet/freezer/kitchen,/turf/simulated/floor/tiled/freezer,/area/space)
"hl" = (/obj/machinery/atmospherics/unary/vent_scrubber/on{dir = 8},/obj/structure/urinal{pixel_x = 29; pixel_y = -2},/turf/simulated/floor/tiled/freezer,/area/space)
"hp" = (/obj/structure/closet/gmcloset{name = "formal wardrobe"},/obj/machinery/light/small/hl,/obj/item/device/eftpos{eftpos_name = "Bar EFTPOS scanner"},/obj/item/glass_jar,/turf/simulated/floor/trim/wood,/area/space)
"hy" = (/obj/effect/floor_decal/corner/red{dir = 10},/obj/machinery/door/window/westleft{dir = 2; name = "Bar"; req_access = list(25)},/obj/machinery/door/blast/shutters{density = 0; dir = 2; icon_state = "shutter0"; id = "bar_shutters"; name = "Saloon Shutters"; opacity = 0},/obj/machinery/atmospherics/pipe/simple/hidden/supply,/obj/machinery/atmospherics/pipe/simple/hidden/scrubbers,/obj/structure/disposalpipe/segment,/obj/structure/cable/white{icon_state = "1-2"},/obj/item/device/radio/intercom{dir = 4; pixel_x = -22},/turf/simulated/floor/tiled/dark/rough,/area/space)
"il" = (/obj/effect/floor_decal/corner/red{dir = 10},/obj/structure/table/darkwood_reinforced,/obj/item/reagent_containers/rag,/obj/item/music_tape_box/frontier,/obj/item/book/wiki/barman_recipes,/obj/item/screwdriver,/obj/item/clothing/head/that{pixel_x = 4; pixel_y = 6},/obj/machinery/atmospherics/unary/vent_pump/on{dir = 1; layer = 2.4; level = 2},/obj/machinery/door/blast/shutters{density = 0; dir = 2; icon_state = "shutter0"; id = "bar_shutters"; name = "Saloon Shutters"; opacity = 0},/turf/simulated/floor/tiled/dark/rough,/area/space)
"iP" = (/obj/machinery/vending/snack,/turf/simulated/floor/tiled/dark/rough,/area/space)
"iU" = (/obj/effect/floor_decal/corner/blue/diagonal,/obj/machinery/cooker/oven,/obj/machinery/alarm{dir = 4; pixel_x = -24},/turf/simulated/floor/tiled/white/rough,/area/space)
"jr" = (/obj/structure/closet/secure_closet/freezer/fridge,/turf/simulated/floor/tiled/freezer,/area/space)
"kQ" = (/obj/machinery/door/window/southright{name = "Kitchen"; req_access = list(28)},/obj/machinery/door/blast/shutters{density = 0; dir = 2; icon_state = "shutter0"; id = "kitchen_shutters"; name = "Kitchen Shutters"; opacity = 0},/obj/effect/floor_decal/corner/red/diagonal{dir = 8},/obj/item/device/radio/intercom{dir = 8; pixel_x = 22},/turf/simulated/floor/tiled/dark/rough,/area/space)
"mr" = (/obj/structure/bed/couch/sofa/left{dir = 4},/turf/simulated/floor/trim/wood,/area/space)
"nD" = (/obj/machinery/recharge_station,/obj/machinery/newscaster{dir = 4; pixel_x = -32},/turf/simulated/floor/tiled/freezer,/area/space)
"oB" = (/obj/machinery/atmospherics/unary/vent_pump/on{dir = 4},/obj/structure/urinal{pixel_x = -30},/turf/simulated/floor/tiled/freezer,/area/space)
"pe" = (/obj/machinery/vending/coffee,/turf/simulated/floor/tiled/dark/rough,/area/space)
"pF" = (/obj/machinery/gibber,/turf/simulated/floor/tiled/freezer,/area/space)
"qe" = (/turf/simulated/floor/tiled/freezer,/area/space)
"qx" = (/obj/structure/table/marble,/obj/machinery/door/blast/shutters{density = 0; dir = 2; icon_state = "shutter0"; id = "kitchen_shutters"; name = "Kitchen Shutters"; opacity = 0},/obj/effect/floor_decal/corner/red/diagonal{dir = 8},/obj/item/storage/box/donut,/obj/machinery/atmospherics/unary/vent_pump/on{dir = 1; layer = 2.4; level = 2},/turf/simulated/floor/tiled/dark/rough,/area/space)
"rQ" = (/obj/structure/bookcase,/obj/item/reagent_containers/vessel/bottle/wine{pixel_x = -4; pixel_y = 8},/obj/item/reagent_containers/vessel/bottle/wine{pixel_y = -3},/obj/item/reagent_containers/vessel/bottle/wine{pixel_x = -8; pixel_y = -3},/obj/item/reagent_containers/vessel/bottle/wine,/obj/item/reagent_containers/vessel/bottle/wine{pixel_x = 6; pixel_y = 9},/turf/simulated/floor/trim/wood,/area/space)
"se" = (/obj/machinery/door/airlock{name = "Unisex Restrooms"},/turf/simulated/floor/tiled/dark/rough,/area/space)
"sA" = (/obj/machinery/door/airlock/freezer{name = "Kitchen cold room"; req_access = list(28)},/turf/simulated/floor/tiled/freezer,/area/space)
"sB" = (/obj/item/device/radio/intercom{pixel_y = 22},/turf/simulated/floor/tiled/freezer,/area/space)
"ta" = (/obj/machinery/door/airlock{name = "Saloon"; req_access = list(25)},/turf/simulated/floor/tiled/dark/rough,/area/space)
"tM" = (/obj/structure/bed,/obj/item/bedsheet/brown,/obj/item/storage/secure/safe{pixel_x = 5; pixel_y = -26},/turf/simulated/floor/trim/carpet/oldred,/area/space)
"uu" = (/obj/effect/floor_decal/corner/blue/diagonal,/obj/machinery/vending/dinnerware,/turf/simulated/floor/tiled/white/rough,/area/space)
"wo" = (/obj/machinery/light/small/hl{dir = 8},/obj/machinery/atmospherics/pipe/simple/hidden/supply,/obj/machinery/atmospherics/pipe/simple/hidden/scrubbers,/obj/structure/disposalpipe/segment,/obj/structure/cable/white{icon_state = "1-2"},/turf/simulated/floor/trim/wood,/area/space)
"wu" = (/obj/effect/floor_decal/corner/red{dir = 5},/obj/structure/table/steel,/obj/machinery/reagentgrinder,/obj/effect/landmark/roundstart/monkeyportrait{pixel_y = 28},/turf/simulated/floor/tiled/dark/rough,/area/space)
"wA" = (/obj/machinery/door/window/southleft{name = "Bar Delivery"; req_access = list(25)},/obj/machinery/navbeacon/delivery/Bar,/obj/effect/floor_decal/industrial/hatch/yellow,/obj/structure/plasticflaps{opacity = 1},/obj/machinery/door/firedoor/border_only,/obj/machinery/door/firedoor/border_only,/turf/simulated/floor/tiled/dark/rough,/area/space)
"wP" = (/obj/structure/table/darkwood_reinforced,/obj/effect/floor_decal/corner/red{dir = 10},/obj/random/drinkbottle,/obj/machinery/atmospherics/unary/vent_scrubber/on{dir = 1},/obj/machinery/door/blast/shutters{density = 0; dir = 2; icon_state = "shutter0"; id = "bar_shutters"; name = "Saloon Shutters"; opacity = 0},/turf/simulated/floor/tiled/dark/rough,/area/space)
"wZ" = (/obj/structure/closet/secure_closet/freezer/meat,/obj/item/reagent_containers/food/meat,/obj/item/reagent_containers/food/meat,/obj/item/reagent_containers/food/meat,/obj/item/reagent_containers/food/meat,/obj/item/reagent_containers/food/meat,/obj/item/reagent_containers/food/meat,/turf/simulated/floor/tiled/freezer,/area/space)
"xt" = (/obj/structure/bed/couch/sofa/right{dir = 8},/turf/simulated/floor/trim/wood,/area/space)
"yj" = (/obj/structure/sink/kitchen{dir = 8; pixel_x = 20; pixel_y = 1},/turf/simulated/floor/tiled/freezer,/area/space)
"yC" = (/turf/simulated/wall,/area/space)
"yQ" = (/obj/effect/floor_decal/corner/blue/diagonal,/turf/simulated/floor/tiled/white/rough,/area/space)
"zg" = (/obj/machinery/door/airlock{name = "Unit 2"},/turf/simulated/floor/tiled/freezer,/area/space)
"zk" = (/obj/machinery/atmospherics/pipe/manifold/hidden/supply{dir = 4},/obj/machinery/atmospherics/pipe/manifold/hidden/scrubbers{dir = 4},/obj/structure/disposalpipe/segment{dir = 8; icon_state = "pipe-c"},/obj/structure/cable/white{icon_state = "1-2"},/turf/simulated/floor/trim/wood,/area/space)
"zH" = (/obj/structure/table/marble,/obj/machinery/door/blast/shutters{density = 0; dir = 2; icon_state = "shutter0"; id = "kitchen_shutters"; name = "Kitchen Shutters"; opacity = 0},/obj/effect/floor_decal/corner/red/diagonal{dir = 8},/obj/machinery/atmospherics/unary/vent_scrubber/on{dir = 1},/turf/simulated/floor/tiled/dark/rough,/area/space)
"Az" = (/obj/structure/table/darkwood_reinforced,/obj/machinery/door/blast/shutters{density = 0; dir = 8; icon_state = "shutter0"; id = "bar_shutters"; name = "Saloon Shutters"; opacity = 0},/obj/effect/floor_decal/corner/red{dir = 9},/obj/item/material/ashtray/bronze,/turf/simulated/floor/tiled/dark/rough,/area/space)
"AW" = (/obj/effect/floor_decal/corner/red{dir = 5},/obj/structure/table/steel,/obj/machinery/chemical_dispenser/bar_alc/full,/obj/machinery/light/small/hl{dir = 1; icon_state = "hanginglantern1"},/turf/simulated/floor/tiled/dark/rough,/area/space)
"Bp" = (/obj/machinery/atmospherics/pipe/simple/hidden/supply{dir = 4},/obj/machinery/atmospherics/pipe/manifold/hidden/scrubbers{dir = 1},/obj/structure/cable/white{icon_state = "4-8"},/obj/effect/landmark/start/crew/barmonkey,/turf/simulated/floor/tiled/dark/rough,/area/space)
"BB" = (/obj/structure/sink{dir = 8; pixel_x = -11},/obj/structure/mirror{pixel_x = -28},/turf/simulated/floor/tiled/freezer,/area/space)
"BO" = (/obj/machinery/firealarm{dir = 8; pixel_x = -24; pixel_y = -2},/turf/simulated/floor/tiled/dark/rough,/area/space)
"BP" = (/obj/machinery/atmospherics/pipe/manifold/hidden/supply{dir = 4},/obj/machinery/atmospherics/pipe/simple/hidden/scrubbers{dir = 9},/obj/structure/cable/white{icon_state = "1-8"},/obj/effect/landmark/start/crew/barmonkey,/obj/machinery/button/remote/blast_door{dir = 8; id = "bar_shutters"; name = "Bar Shutters Control"; pixel_x = 23; req_access = list(25)},/turf/simulated/floor/tiled/dark/rough,/area/space)
"Cq" = (/obj/structure/table/darkwood_reinforced,/obj/effect/floor_decal/corner/red,/obj/random/drinkbottle,/obj/machinery/door/blast/shutters{density = 0; dir = 2; icon_state = "shutter0"; id = "bar_shutters"; name = "Saloon Shutters"; opacity = 0},/turf/simulated/floor/tiled/dark/rough,/area/space)
"CA" = (/obj/machinery/atmospherics/pipe/simple/hidden/supply,/obj/machinery/atmospherics/pipe/simple/hidden/scrubbers,/obj/structure/disposalpipe/segment,/obj/structure/cable/white{icon_state = "1-2"},/obj/machinery/firealarm{dir = 8; pixel_x = -24; pixel_y = -2},/turf/simulated/floor/trim/wood,/area/space)
"CU" = (/obj/structure/closet/secure_closet/bar,/obj/item/gun/projectile/shotgun/doublebarrel,/obj/item/storage/box/shotgun/beanbags,/obj/machinery/atmospherics/unary/vent_scrubber/on{dir = 4},/obj/machinery/alarm{dir = 4; pixel_x = -24},/turf/simulated/floor/trim/wood,/area/space)
"DM" = (/obj/structure/table/steel,/obj/effect/floor_decal/corner/red{dir = 5},/obj/machinery/chemical_dispenser/bar_soft/full,/obj/machinery/light/small/hl{dir = 1; icon_state = "hanginglantern1"},/turf/simulated/floor/tiled/dark/rough,/area/space)
"EC" = (/obj/structure/closet{icon_closed = "cabinet_closed"; icon_opened = "cabinet_open"; icon_state = "cabinet_closed"; name = "Clothing Storage"},/obj/item/clothing/head/fedora,/obj/item/clothing/suit/storage/leather_jacket,/obj/item/clothing/under/gentlesuit,/obj/item/clothing/under/waiter,/obj/item/clothing/shoes/black,/obj/item/clothing/shoes/laceup,/obj/item/clothing/under/suit_jacket/checkered,/turf/simulated/floor/trim/wood,/area/space)
"EL" = (/obj/structure/extinguisher_cabinet{pixel_x = 33},/turf/simulated/floor/tiled/dark/rough,/area/space)
"EX" = (/obj/effect/floor_decal/corner/blue/diagonal,/obj/structure/table/marble,/obj/machinery/microwave{pixel_y = 6},/turf/simulated/floor/tiled/white/rough,/area/space)
"Fe" = (/turf/simulated/floor/tiled/dark/rough,/area/space)
"Fq" = (/obj/structure/table/marble,/obj/machinery/door/blast/shutters{density = 0; dir = 2; icon_state = "shutter0"; id = "kitchen_shutters"; name = "Kitchen Shutters"; opacity = 0},/obj/effect/floor_decal/corner/red/diagonal{dir = 8},/obj/item/reagent_containers/vessel/condiment/small/saltshaker,/obj/item/reagent_containers/vessel/condiment/small/peppermill{pixel_x = -3; pixel_y = 2},/obj/item/storage/pill_bottle/sugar_cubes,/obj/structure/sign/poster{pixel_x = -32},/turf/simulated/floor/tiled/dark/rough,/area/space)
"FI" = (/obj/effect/floor_decal/spline/fancy/wood{dir = 4},/obj/machinery/atmospherics/pipe/simple/hidden/supply,/obj/structure/cable/white{icon_state = "1-2"},/turf/simulated/floor/trim/wood,/area/space)
"Gk" = (/obj/structure/table/woodentable,/obj/item/reagent_containers/vessel/shaker,/obj/item/packageWrap,/obj/item/wrapping_paper,/obj/item/device/destTagger{pixel_x = 4; pixel_y = 3},/obj/item/deck/cards,/obj/item/deck/cards,/obj/item/deck/cards,/obj/random/music_tape,/obj/machinery/atmospherics/unary/vent_pump/on{dir = 8; layer = 2.4; level = 2},/obj/item/device/flashlight/lantern/active,/turf/simulated/floor/trim/carpet/oldred,/area/space)
"Gx" = (/obj/structure/disposaloutlet{dir = 1},/turf/simulated/floor/tiled/freezer,/area/space)
"GK" = (/obj/structure/sink{dir = 4; pixel_x = 11},/obj/structure/mirror{pixel_x = 30},/obj/machinery/power/apc{name = "south bump"; pixel_y = -24},/turf/simulated/floor/tiled/freezer,/area/space)
"HK" = (/obj/effect/floor_decal/spline/fancy/wood{dir = 4},/obj/machinery/light/small/hl{dir = 1; icon_state = "hanginglantern1"},/obj/structure/sign/poster{pixel_y = 32},/obj/machinery/atmospherics/pipe/simple/hidden/supply{dir = 6},/obj/structure/cable/white{icon_state = "2-4"},/obj/machinery/camera/network/civilian_east{c_tag = "Bar Cafe"},/turf/simulated/floor/trim/wood,/area/space)
"HM" = (/obj/structure/flora/pottedplant/flowerbushred,/obj/item/device/radio/intercom{dir = 4; pixel_x = -22},/turf/simulated/floor/tiled/dark/rough,/area/space)
"Ja" = (/turf/simulated/floor/trim/carpet/oldred,/area/space)
"JG" = (/obj/structure/table/darkwood_reinforced,/obj/effect/floor_decal/corner/red{dir = 8},/obj/item/reagent_containers/rag,/obj/machinery/door/blast/shutters{density = 0; dir = 2; icon_state = "shutter0"; id = "bar_shutters"; name = "Saloon Shutters"; opacity = 0},/turf/simulated/floor/tiled/dark/rough,/area/space)
"KM" = (/obj/structure/sink/kitchen{dir = 8; pixel_x = 21},/obj/structure/mirror{pixel_x = 30},/turf/simulated/floor/trim/wood,/area/space)
"Lz" = (/obj/machinery/media/jukebox,/obj/machinery/light/small/hl,/turf/simulated/floor/trim/wood,/area/space)
"LY" = (/obj/machinery/door/airlock/maintenance{name = "Saloon Maintenance"; req_access = list(25); req_one_access = list()},/turf/simulated/floor/trim/wood,/area/space)
"Me" = (/obj/machinery/atmospherics/pipe/simple/hidden/supply{dir = 6},/obj/machinery/atmospherics/pipe/simple/hidden/scrubbers{dir = 6},/obj/structure/disposalpipe/segment,/obj/structure/cable/white{icon_state = "2-4"},/obj/machinery/alarm{dir = 4; pixel_x = -25},/turf/simulated/floor/tiled/dark/rough,/area/space)
"MM" = (/obj/structure/kitchenspike,/turf/simulated/floor/tiled/freezer,/area/space)
"Nl" = (/turf/simulated/floor/trim/wood,/area/space)
"Nt" = (/obj/structure/bed/couch/sofa/right{dir = 4},/turf/simulated/floor/trim/wood,/area/space)
"Rb" = (/obj/machinery/door/airlock{name = "Unit 1"},/turf/simulated/floor/tiled/freezer,/area/space)
"RJ" = (/obj/machinery/light/small/hl{dir = 1; icon_state = "hanginglantern1"},/turf/simulated/floor/trim/wood,/area/space)
"RN" = (/turf/space,/area/space)
"Te" = (/obj/structure/bed/couch/sofa/left{dir = 8},/turf/simulated/floor/trim/wood,/area/space)
"Tq" = (/obj/structure/toilet,/obj/machinery/newscaster{dir = 4; pixel_x = -32},/turf/simulated/floor/tiled/freezer,/area/space)
"Ul" = (/obj/structure/table/darkwood_reinforced,/obj/effect/floor_decal/corner/red/three_quarters,/obj/machinery/door/blast/shutters{density = 0; dir = 2; icon_state = "shutter0"; id = "bar_shutters"; name = "Saloon Shutters"; opacity = 0},/obj/item/dice,/obj/item/device/flashlight/lantern/active,/turf/simulated/floor/tiled/dark/rough,/area/space)
"Un" = (/obj/structure/table/darkwood_reinforced,/obj/machinery/door/blast/shutters{density = 0; dir = 4; icon_state = "shutter0"; id = "bar_shutters"; name = "Saloon Shutters"; opacity = 0},/obj/effect/floor_decal/corner/red{dir = 6},/obj/random/smokes,/turf/simulated/floor/tiled/dark/rough,/area/space)
"Vz" = (/obj/structure/table/darkwood_reinforced,/obj/effect/floor_decal/corner/red/three_quarters{dir = 4},/obj/item/material/ashtray/bronze,/obj/machinery/door/blast/shutters{density = 0; dir = 2; icon_state = "shutter0"; id = "bar_shutters"; name = "Saloon Shutters"; opacity = 0},/turf/simulated/floor/tiled/dark/rough,/area/space)
"Xb" = (/obj/effect/floor_decal/corner/blue/diagonal,/obj/machinery/disposal,/turf/simulated/floor/tiled/white/rough,/area/space)
"Xn" = (/obj/structure/table/darkwood_reinforced,/obj/effect/floor_decal/corner/red{dir = 10},/obj/random/drinkbottle,/obj/machinery/door/blast/shutters{density = 0; dir = 2; icon_state = "shutter0"; id = "bar_shutters"; name = "Saloon Shutters"; opacity = 0},/turf/simulated/floor/tiled/dark/rough,/area/space)
"Xr" = (/obj/machinery/atmospherics/pipe/simple/hidden/supply{dir = 4},/obj/machinery/atmospherics/pipe/simple/hidden/scrubbers{dir = 4},/obj/structure/cable/white{icon_state = "4-8"},/turf/simulated/floor/tiled/dark/rough,/area/space)
"XM" = (/obj/effect/floor_decal/corner/red{dir = 5},/obj/machinery/vending/boozeomat,/obj/structure/sign/double/barsign{pixel_x = -17; pixel_y = 32},/turf/simulated/floor/tiled/dark/rough,/area/space)
"Yo" = (/obj/effect/floor_decal/corner/red{dir = 5},/obj/machinery/disposal,/obj/structure/sign/poster{pixel_y = 32},/obj/structure/disposalpipe/trunk,/obj/machinery/firealarm{dir = 8; pixel_x = -24; pixel_y = -2},/turf/simulated/floor/tiled/dark/rough,/area/space)

(1,1,1) = {"
RNRNRNRNRNRNRNRNRNRNRNRNRNRNRNRNRNRNRNRNRNRN
RNRNRNRNRNRNRNRNRNRNRNRNRNRNRNRNRNRNRNRNRNRN
RNRNRNRNRNRNRNRNRNRNRNRNRNRNRNRNRNRNRNRNRNRN
RNRNRNRNRNRNRNRNRNRNRNRNRNRNRNRNRNRNRNRNRNRN
RNRNRNRNRNRNRNyCyCwAyCyCyCRNRNRNRNRNRNRNRNRN
RNRNRNRNRNRNRNyChpNlGkrQyCRNRNRNRNRNRNRNRNRN
RNRNRNRNRNRNRNyCCUNlNlNlLYRNRNRNRNRNRNRNRNRN
RNRNRNRNRNRNRNyCECtMNlKMyCRNRNRNRNRNRNRNRNRN
RNRNRNRNRNRNyCyCyCyCyCtayCRNRNRNRNRNRNRNRNRN
RNRNRNRNRNRNYowuAWXMDMFeyCRNRNRNRNRNRNRNRNRN
RNRNRNRNRNRNMeBpXrXrXrBPyCyCyCyCyCyCRNRNRNRN
RNRNRNRNRNRNhywPJGfwCqilyCyCTqyCnDyCRNRNRNRN
RNRNRNRNRNRNCAehAzFeUnehHKyCRbyCzgyCRNRNRNRN
RNRNRNRNRNRNwoehUlXnVzehFIyCoBsBhlyCRNRNRNRN
RNRNRNRNRNRNzkJaehehehJaFIyCBBqeGKyCRNRNRNRN
RNRNRNRNRNRNmrNlxtLzmrNlxtyCyCseyCyCyCRNRNRN
RNRNRNRNRNRNNtNlTeyCNtNlTeyCBOFeFeELyCRNRNRN
RNRNRNRNRNRNNlNlNlRJNlNlNleqFeFeFepeyCRNRNRN
RNRNRNRNRNRNNlNlNlNlNlNlNlyCHMFeaeiPyCRNRNRN
RNRNRNRNRNRNyCyCFqqxzHkQyCyCyCyCyCyCyCRNRNRN
RNRNRNRNRNRNyCeDyQyQyQyQyCpFMMqeqeyCRNRNRNRN
RNRNRNRNRNRNyCefyQEXyQyQsAqeqeqeyjyCRNRNRNRN
RNRNRNRNRNRNyCiUyQyQyQuuyCgpjrwZGxyCRNRNRNRN
RNRNRNRNRNRNyCyCdidhXbyCyCyCyCyCyCyCRNRNRNRN
RNRNRNRNRNRNRNyCyCyCyCyCRNRNRNRNRNRNRNRNRNRN
RNRNRNRNRNRNRNRNRNRNRNRNRNRNRNRNRNRNRNRNRNRN
RNRNRNRNRNRNRNRNRNRNRNRNRNRNRNRNRNRNRNRNRNRN
RNRNRNRNRNRNRNRNRNRNRNRNRNRNRNRNRNRNRNRNRNRN
RNRNRNRNRNRNRNRNRNRNRNRNRNRNRNRNRNRNRNRNRNRN
"}
